واضح	स्पष्ट
کرہ	क्षेत्र
کوتاہیوں	कमियों
انتہائی	अत्यधिक
مرعوب	प्रभावित
سمت	दिशा
مُنتخب	पसंदीदा
شعائیں	किरणें
جلالی	गौरवशाली
مابین	बीच
دریافت	खोज
مزید	अधिक
ابتلا	आज़माइश, इम्तहान, मुसीबत
نباتات	वनस्पति
حیاتی	जैव
آگاہ	अवगत
زعفران	केसर
اطلاع	सूचना
اضافہ	वृद्धि
سکوت	सन्नाटा
جنوب	दक्षिण
اسرار	रहस्य
علاحدہ	अलग
عقیدہ	पंथ, इमान
خودمختار	स्वतंत्र
تعلق	लगाव, वास्ता
باغ باغ	निहायत ख़ुशी
میسر	जो चीज़ जो आसानी से हासिल हो, मौजूद
